▤▤▤▤▤▤▤▤▤▤▤▤▤▤▤▤▤▤▤▤▤▤▤▤▤▤▤▤▤▤▤▤▤▤▤▤▤▤▤▤▤▤▤▤▤▤▤▤▤▤▤▤▤▤▤▤▤▤▤▤▤▤▤▤▤▤▤▤▤▤▤▤▤▤▤▤▤▤▤▤
▤                            ▤ ♣                         ♣▤   ▤ ★    ▤    ▤    ▤
▤                            ▤ ♣                         ♣▤      ▤     ▤    ▤  ▤
▤                            ▤ ♣                         ♣▤▤▤▤▤▤▤▤▤▤▤▤▤▤▤▤▤▤▤▤▤▤
▤                     ☠      ▤      ☠                                          ▤
▤                            ▤                            ▤                    ▤
▤        ▤▤▤▤▤▤▤▤ ♣♣♣♣♣♣♣♣♣  ▤ ♣♣♣♣♣♣♣♣♣         ♣♣♣♣♣♣♣♣♣▤                    ▤
▤ ♣♣♣♣♣♣ ▤      ▤ ♣♣♣♣♣♣♣♣♣  ▤ ♣♣♣♣♣♣♣♣♣         ♣♣♣♣♣♣♣♣♣▤                    ▤
▤ ♣♣♣♣♣♣ ▤      ▤ ♣♣♣♣♣♣♣♣♣  ▤ ♣♣♣♣♣♣♣♣♣         ♣♣♣♣♣♣♣♣♣▤                    ▤
▤ ♣♣♣♣♣♣ ▤      ▤▤▤▤▤▤▤▤▤▤▤  ▤ ♣♣♣♣♣♣♣♣♣         ♣♣♣♣♣♣♣♣♣▤                    ▤
▤        ▤  ☠                ▤  ☠ ♣♣♣♣♣♣         ♣♣♣♣♣♣♣♣♣▤                    ▤
▤        ▤                   ▤    ♣♣♣♣♣♣         ♣♣♣♣♣♣♣♣♣▤                    ▤
▤        ▤▤▤▤▤▤▤▤▤▤▤▤▤▤▤▤▤▤▤▤▤ ♣♣♣♣♣♣♣♣♣                  ▤                    ▤
▤   ♣♣♣♣♣♣♣♣♣♣♣♣♣♣♣♣♣♣♣♣     ▤ ♣♣♣♣♣♣♣♣♣                  ▤                    ▤
▤   ♣♣♣♣♣♣♣♣♣♣♣♣♣♣♣♣♣♣♣♣     ▤ ♣♣♣♣♣♣♣♣♣                  ▤                    ▤
▤   ♣♣♣♣♣♣♣♣♣♣♣♣♣♣♣♣♣♣♣♣☺    ▤                            ▤                    ▤
▤▤▤▤▤▤▤▤▤▤▤▤▤▤▤▤▤▤▤▤▤▤▤▤▤▤                                ▤                    ▤
                         ▤ O         ♣♣♣♣♣♣♣♣♣♣♣♣♣♣♣♣♣♣♣♣♣▤                    ▤
                         ▤ ☠         ♣♣♣♣♣♣♣♣♣♣♣♣♣♣♣♣♣♣♣♣♣▤                    ▤
                         ▤ O         ♣♣♣♣♣♣♣♣♣♣♣♣♣♣♣♣♣♣♣♣♣▤▤▤▤▤▤▤▤▤▤▤▤▤▤▤▤▤▤▤▤▤▤
                         ▤▤▤▤▤▤▤▤▤▤▤▤▤▤▤▤▤▤▤▤▤▤▤▤▤▤▤▤▤▤▤▤▤▤                     