▤▤▤▤▤▤▤▤▤▤▤▤▤▤▤▤▤▤▤▤▤▤▤▤▤▤▤▤▤▤▤▤▤▤▤▤▤▤▤▤▤▤▤▤▤▤▤▤▤▤▤▤▤▤▤▤▤▤▤▤▤▤▤▤▤▤▤▤▤▤▤▤▤▤▤▤▤▤▤▤ 
▤                            ▤                            ▤   ▤     ▤     ▤    ▤ 
▤                            ▤                            ▤      ▤     ▤    ▤  ▤ 
▤                            ▤                            ▤▤▤▤▤▤▤▤▤▤▤▤▤▤▤▤▤▤▤▤▤▤ 
▤                            ▤                                                 ▤ 
▤                            ▤                            ▤                    ▤ 
▤        ▤▤▤▤▤▤▤▤            ▤                            ▤                    ▤ 
▤        ▤      ▤            ▤                            ▤                    ▤ 
▤        ▤      ▤            ▤                          ☺ ▤                    ▤ 
▤        ▤      ▤▤▤▤▤▤▤▤▤▤▤  ▤                            ▤                    ▤ 
▤        ▤                   ▤               ☠            ▤                    ▤ 
▤        ▤                   ▤                            ▤                    ▤ 
▤        ▤▤▤▤▤▤▤▤▤▤▤▤▤▤▤▤▤▤▤▤▤                            ▤                    ▤ 
▤                            ▤                            ▤                    ▤ 
▤                            ▤                            ▤                    ▤ 
▤                            ▤                            ▤                    ▤ 
▤▤▤▤▤▤▤▤▤▤▤▤▤▤▤▤▤▤▤▤▤▤▤▤▤▤                                ▤                    ▤ 
                         ▤ O                              ▤                    ▤ 
                         ▤ ☠                              ▤                    ▤ 
                         ▤ O                              ▤▤▤▤▤▤▤▤▤▤▤▤▤▤▤▤▤▤▤▤▤▤ 
                         ▤▤▤▤▤▤▤▤▤▤▤▤▤▤▤▤▤▤▤▤▤▤▤▤▤▤▤▤▤▤▤▤▤▤                      
                                                                                 
                                                                                 
                                                                                 
                                                                                 
                                                                                 